XXXXXXXXXXXXXXXXXXXXXXXXXXXXXX
X  P                         X
XXXXXXXXXXXXX   XXXXXXXXXXXXXX
X                            X
XXXXXXXXXXXXXXXXXX   XXXXXXXXX
X                            X
XXXXX   XXXXXXXXXXXXXXXXXXXXXX
X                            X
XXXXXXXXXXXXXX   XXXXXXXXXXXXX
X                            X
XXXXXXXXXXXXXXXXXXXXXXXXEXXXXX